NO ./textures/wall_floor/no.xpm
SO ./textures/wall_floor/so.xpm
WE ./textures/wall_floor/we.xpm
EA ./textures/wall_floor/ea.xpm
F 1,16
C 40,45,50

11111
10N01
10001
11111
