NO ./textures/north.xpm
SO ./textures/south.xpm
WE ./textures/west.xpm
EA ./textures/east.xpm
F 1,16
C 225,30,0

111111
100001
1N0001
100001
111111
