NO ./textures/north.xpm
SO ./textures/south.xpm
WE ./textures/west.xpm
EA ./textures/east.xpm
F 100,149,237
C 50,50,50

1111111111111111111
1000000000000000001
1000100010001000001
1000100010001000001
1001100011001100001
100000N000000000001
1001100011001100001
1000100010001000001
1000100010001000001
1000000000000000001
1111111111111111111
