NO ./textures/wall_floor/no.xpm
SO ./textures/wall_floor/so.xpm
WE ./textures/wall_floor/we.xpm
EA ./textures/wall_floor/ea.xpm
F 1,16,26
C 40,45,50

11111111111
10000000001
10N00000001
10000000001
10002000001
10000000001
10000000001
11111111111
