NO ./textures/wall_floor/no.xpm
SO ./textures/wall_floor/so.xpm
WE ./textures/wall_floor/we.xpm
EA ./textures/wall_floor/ea.xpm
F 1,16,26
C 40,45,50

11111111111111111111111111111
10000000001100000000000011111
10110000011100000000000011111
10010000000000000000000011111
11111111101100000111000000001
10000000001100000111011111111
11110111111111011100000010001
11110111111111011101010010001
11000000110101011100000010001
10000000000000001100000010001
10000000000000001101010010001
110000011101010111110110N0111
11110111111010110111101000111
11111111111111111111111111111
